+--+--+--+--+--+--+--+--+--+--+
S     |              |     |  |
+--+  +  +--+--+--+  +  +  +  +
|     |     |     |  |  |  |  |
+  +--+  +--+  +  +  +--+  +  +
|     |  |     |  |  |     |  |
+--+  +  +  +--+  +  +  +--+  +
|     |     |     |     |     |
+  +--+--+--+--+  +--+--+--+  +
|           |                 |
+--+--+--+  +  +  +--+--+--+  +
|     |  |     |  |     |     |
+--+  +  +--+--+  +  +  +--+  +
|     |           |  |        |
+  +--+--+  +--+--+  +--+--+--+
|           |        |  |     |
+--+--+--+--+  +--+--+  +  +  +
|           |     |        |  |
+  +--+--+  +  +  +--+  +--+  +
|        |     |        |     G
+--+--+--+--+--+--+--+--+--+--+


+--+--+--+--+--+--+--+--+--+--+--+--+--+--+--+--+--+--+--+--+
S   |     |                 |     |  |              |       |
+  +--+  +  +  +--+--+--+  +  +  +  +  +  +--+--+  +  +--+  +
|  |     |  |        |        |     |  |  |     |  |     |  |
+  +  +--+--+--+--+  +  +--+--+--+--+  +--+  +  +  +--+  +  +
|     |     |        |  |              |     |  |  |     |  |
+  +--+  +  +  +--+--+  +  +--+--+--+--+  +--+  +  +  +--+  +
|  |     |     |        |     |     |     |     |     |     |
+  +  +--+--+--+  +--+--+--+  +  +  +  +--+--+  +  +--+  +--+
|     |           |        |     |  |  |  |     |  |     |  |
+--+--+  +--+--+  +--+--+  +--+--+  +  +  +  +--+  +  +--+  +
|     |     |  |  |     |  |        |     |        |  |     |
+  +--+  +  +  +  +  +  +  +  +--+--+  +--+--+--+--+  +  +--+
|        |     |     |  |  |        |     |     |  |     |  |
+  +--+--+--+--+--+--+  +  +--+--+  +  +  +--+  +  +--+--+  +
|  |     |     |        |     |     |  |        |  |        |
+  +  +--+  +  +--+  +  +--+  +  +--+  +--+--+--+  +  +--+  +
|  |        |        |        |     |     |        |     |  |
+  +--+--+--+  +--+--+--+--+--+--+  +  +  +  +--+--+--+  +  +
|     |        |     |     |        |  |     |        |  |  |
+--+  +--+--+--+  +  +  +  +--+--+--+--+  +--+  +  +  +  +  +
|     |        |  |     |                       |  |     |  |
+  +--+  +--+  +--+  +--+--+--+--+--+--+  +--+--+--+--+--+  +
|     |     |     |  |     |        |     |  |              |
+  +--+--+  +--+  +  +  +--+  +  +  +  +--+  +  +--+--+--+--+
|        |     |  |  |        |  |  |  |                    |
+--+--+  +--+  +  +  +--+--+--+  +--+  +--+--+--+--+--+--+  +
|     |  |     |  |     |     |     |  |              |     |
+--+  +  +  +--+  +  +  +  +--+--+  +  +  +--+  +--+  +  +--+
|     |  |     |     |  |        |     |     |     |  |  |  |
+  +--+  +--+  +--+--+  +--+--+  +--+--+  +  +--+  +  +  +  +
|     |        |  |     |     |  |     |  |  |     |     |  |
+--+  +--+  +--+  +  +--+  +  +  +  +  +  +  +  +--+--+--+  +
|  |        |     |        |     |  |  |  |  |     |        |
+  +--+  +--+  +  +--+--+--+  +--+  +  +--+  +--+--+  +--+--+
|        |     |  |           |     |  |     |     |  |     |
+--+--+--+--+--+  +  +  +--+--+  +--+  +  +--+  +  +  +  +--+
|              |  |  |  |        |  |     |     |     |     |
+  +  +--+--+  +  +--+  +  +--+--+  +--+--+  +  +--+--+  +  +
|  |        |           |                    |           |  G
+--+--+--+--+--+--+--+--+--+--+--+--+--+--+--+--+--+--+--+--+
