+--+--+--+--+--+--+--+--+--+--+
S     |              |     |  |
+--+  +  +--+--+--+  +  +  +  +
|     |     |     |  |  |  |  |
+  +--+  +--+  +  +  +--+  +  +
|     |  |     |  |  |     |  |
+--+  +  +  +--+  +  +  +--+  +
|     |     |     |     |     |
+  +--+--+--+--+  +--+--+--+  +
|           |                 |
+--+--+--+  +  +  +--+--+--+  +
|     |  |     |  |     |     |
+--+  +  +--+--+  +  +  +--+  +
|     |           |  |        |
+  +--+--+  +--+--+  +--+--+--+
|           |        |  |     |
+--+--+--+--+  +--+--+  +  +  +
|           |     |        |  |
+  +--+--+  +  +  +--+  +--+  +
|        |     |        |     G
+--+--+--+--+--+--+--+--+--+--+
